1,1,1,1,1,1,1,1,1,1,1,1,1,1,1,1,1,1,1,1
1,0,0,0,0,0,0,0,0,0,0,0,0,0,0,0,0,0,0,1
1,0,0,0,0,0,0,0,0,0,0,0,0,0,0,0,0,0,0,1
1,0,0,0,0,0,0,0,0,0,0,0,0,0,0,0,0,0,0,1
1,0,0,0,0,0,0,0,0,0,0,0,0,0,0,0,0,0,0,1
1,0,0,0,0,0,0,0,0,0,0,0,0,0,0,0,0,0,0,1
1,0,0,0,0,0,0,0,0,0,0,0,0,0,0,0,0,0,0,1
1,0,0,0,0,0,0,0,0,0,0,0,1,1,0,0,1,1,0,1
1,0,0,0,0,0,0,0,0,0,0,0,1,1,0,0,1,1,0,1
1,0,0,0,0,0,0,0,0,0,0,0,1,1,0,0,1,1,0,1
1,0,0,0,0,0,0,0,0,0,0,0,1,1,0,0,1,1,0,1
1,0,0,0,0,0,0,0,1,1,0,0,1,1,0,0,1,1,0,1
1,0,0,0,0,0,0,0,1,1,0,0,1,1,0,0,1,1,0,1
1,2,0,0,0,1,5,5,1,1,5,5,1,1,6,6,1,1,3,1
1,1,1,1,1,1,1,1,1,1,1,1,1,1,1,1,1,1,1,1
