1,1,1,1,1,1,1,1,1,1,1,1,1,1,1,1,1,1,1,1
1,0,0,0,0,6,0,0,5,0,0,6,0,6,0,0,0,0,0,1
1,0,0,0,0,1,0,0,5,0,0,0,5,0,5,0,0,0,0,1
1,0,0,1,1,1,1,1,1,1,1,1,1,1,1,1,1,1,0,1
1,0,0,1,0,0,10,0,0,9,0,1,0,0,0,0,1,0,0,1
1,0,0,1,0,0,5,0,0,9,0,9,0,0,0,0,1,0,0,1
1,0,0,1,0,1,1,1,1,1,1,1,1,1,0,0,1,0,7,1
1,0,0,1,0,0,0,0,0,0,0,0,3,1,0,0,1,1,0,1
1,0,0,1,1,1,1,1,1,1,1,1,1,1,0,0,1,0,0,1
1,0,0,0,7,0,0,0,0,0,0,0,0,0,0,0,1,0,0,1
1,0,0,0,1,0,0,0,0,1,0,0,0,0,8,8,1,0,7,1
1,1,0,0,1,0,0,0,0,1,0,0,0,1,9,9,1,1,0,1
1,1,1,1,1,1,1,1,1,1,1,1,1,1,1,1,1,0,0,1
1,2,4,0,0,0,0,0,0,0,0,0,0,0,0,0,0,0,7,1
1,1,1,1,1,1,1,1,1,1,1,1,1,1,1,1,1,1,1,1
