1,1,1,1,1,1,1,1,1,1,1,1,1,1,1,1,1,1,1,1
1,0,0,0,0,0,0,0,0,0,0,0,0,0,0,0,0,0,0,1
1,3,0,0,0,0,0,0,0,0,0,0,0,0,0,0,0,0,0,1
1,1,0,1,1,0,1,1,1,0,1,0,1,1,1,1,0,1,0,1
1,0,0,0,0,0,0,0,0,0,0,0,0,0,0,0,0,0,7,1
1,0,0,0,0,0,0,0,0,0,0,0,0,0,0,0,0,0,0,1
1,0,1,1,1,0,1,1,1,0,1,1,0,0,0,1,1,0,0,1
1,0,0,0,0,0,0,0,0,0,0,0,0,0,0,0,0,0,0,1
1,0,0,0,0,0,0,0,0,0,0,0,0,0,0,0,0,0,1,1
1,7,0,1,1,1,0,0,1,0,1,1,0,0,1,0,0,0,0,1
1,0,0,0,1,1,0,1,1,0,1,1,0,0,1,1,0,0,0,1
1,0,0,0,1,1,0,1,1,0,1,1,0,0,1,1,1,0,4,1
1,1,1,1,1,1,8,1,1,1,1,1,1,8,1,1,1,1,1,1
1,0,0,0,0,0,7,0,0,0,0,0,0,5,0,0,0,0,2,1
1,1,1,1,1,1,1,1,1,1,1,1,1,1,1,1,1,1,1,1
