1,1,1,1,1,1,1,1,1,1,1,1,1,1,1,1,1,1,1,1
1,0,0,0,0,0,0,1,0,1,1,1,1,0,0,0,1,6,0,1
1,1,10,1,0,0,0,1,0,0,0,1,1,0,0,0,0,5,0,1
1,1,5,1,0,0,0,1,0,1,0,1,1,0,0,0,0,1,6,1
1,1,1,1,5,0,0,1,0,1,0,1,1,0,0,0,0,1,3,1
1,0,0,0,0,0,0,1,0,1,0,0,0,0,0,0,0,1,0,1
1,0,0,0,0,0,0,1,0,1,0,1,1,10,10,10,1,1,1,1
1,0,0,0,0,0,0,1,0,1,0,1,1,10,10,10,0,0,0,1
1,0,0,0,0,0,0,1,0,1,0,1,1,0,0,0,0,0,0,1
1,0,0,0,0,0,0,1,0,1,10,1,1,0,0,0,0,0,0,1
1,0,0,0,0,0,0,0,0,0,0,0,1,0,0,0,10,5,0,1
1,0,0,1,1,1,0,0,0,0,0,0,1,0,0,0,10,1,0,1
1,0,0,0,0,0,0,0,0,0,0,0,1,0,0,0,10,10,0,1
1,1,2,5,0,0,0,0,9,0,0,0,0,9,0,0,0,0,0,1
1,1,1,1,1,1,1,1,1,1,1,1,1,1,1,1,1,1,1,1
